100000009
000000609
000000000
000000999
990000000
000000000
000600002
